/Assets/Tiles/basicTileSheet.png
20
14
3 3 3 3 3 3 3 3 3 3 3 3 3 3 3 3 3 3 3 3
3 1 1 1 1 0 1 1 1 1 1 1 1 1 1 1 1 1 1 3
3 1 1 2 2 2 2 2 2 2 1 1 1 1 1 1 1 1 1 3
3 1 1 1 1 1 1 1 1 1 1 1 1 1 1 1 1 1 1 3
3 2 2 1 1 1 1 1 2 2 1 1 1 1 1 1 1 1 0 3
3 3 3 1 2 1 1 2 3 3 2 2 2 1 1 1 2 2 2 3
3 3 1 1 1 1 1 1 1 1 1 1 1 1 1 2 3 1 1 3
3 1 1 1 1 1 1 1 1 1 1 1 1 1 2 3 1 1 1 3
3 1 1 1 1 1 1 2 1 1 2 2 2 2 3 1 1 1 1 3
3 2 2 2 2 2 2 3 1 1 1 1 1 1 1 1 1 1 1 3
3 3 1 1 1 1 1 3 2 2 3 1 1 2 2 2 2 1 1 3
3 3 1 1 1 1 1 1 1 3 3 2 1 1 1 3 3 1 1 3
3 3 1 1 1 3 3 1 1 1 1 1 1 1 1 1 1 1 1 3
3 3 3 3 3 3 3 3 3 3 3 3 3 3 3 3 3 3 3 3
2
0 18 4 10 7
0 5 1 17 12
3
1 18 4
1 2 2
1 5 8



