/Assets/Backgrounds/baackground.jpg
/Assets/Tiles/Bricks.png
30
30
08 08 08 08 08 08 08 08 08 08 08 08 08 08 08 08 08 08 08 08 08 08 08 08 08 08 08 08 08 08
08 04 02 02 02 02 02 02 02 02 08 02 02 02 02 02 02 08 08 08 08 08 08 02 02 02 02 02 02 08
08 04 02 02 02 08 08 08 08 02 08 02 08 08 08 02 02 02 08 08 08 08 08 02 02 02 02 02 02 05
08 08 08 08 08 08 02 02 02 02 08 02 02 02 02 08 02 02 02 02 08 08 08 02 02 08 08 08 08 08
08 08 08 08 08 02 02 02 08 08 08 08 08 02 02 02 08 02 02 02 08 08 08 02 02 02 02 08 08 08
08 08 08 08 02 02 02 08 08 08 08 08 08 08 02 02 02 08 08 02 02 02 08 08 08 02 02 02 08 08
08 08 08 08 02 02 08 08 08 08 08 08 08 08 08 02 02 02 08 08 08 02 02 08 08 08 02 02 02 08
08 02 02 02 02 08 08 08 08 08 08 08 08 08 08 08 02 02 02 08 08 08 08 08 08 08 08 02 02 08
08 02 02 08 08 08 02 02 02 02 02 02 02 02 02 02 02 08 02 02 02 02 02 02 02 02 02 02 02 08
08 02 08 08 08 08 02 02 02 02 02 02 02 02 02 02 02 02 02 02 02 02 02 02 02 02 02 02 08 08
08 02 02 02 08 08 02 08 08 08 08 08 08 08 08 08 08 08 08 02 02 08 08 08 08 08 08 08 08 08
08 08 08 02 08 02 02 02 08 08 08 08 08 08 08 08 08 08 08 02 02 02 08 08 08 08 08 08 02 08
08 08 02 02 08 02 02 02 02 08 08 02 02 02 02 02 02 02 08 08 02 02 02 08 08 08 02 02 02 08
08 02 02 02 08 02 02 08 02 02 08 02 02 02 08 02 02 02 08 08 08 02 02 02 08 02 02 02 02 08
08 02 02 08 08 02 02 08 08 02 08 02 02 02 08 02 02 02 08 08 08 08 02 02 02 02 08 02 02 08
04 02 08 08 02 02 08 02 02 02 08 02 02 02 08 08 02 02 08 08 08 08 08 02 02 08 08 02 08 08
08 08 08 02 02 08 08 02 08 08 08 02 02 02 02 02 02 02 05 08 08 08 02 02 02 02 08 02 02 08
08 02 02 02 08 08 08 02 02 02 08 08 08 08 08 08 08 08 08 08 08 02 02 02 08 02 02 02 02 08
08 02 02 08 08 08 08 08 02 02 02 08 08 08 08 08 08 08 08 08 02 02 02 08 08 08 02 02 08 08
08 02 02 02 08 08 08 08 08 02 02 02 02 08 08 08 08 08 02 02 02 02 08 08 08 08 08 02 08 08
08 08 08 02 02 08 08 08 08 02 02 02 02 02 02 02 02 02 02 02 02 08 08 08 08 02 02 02 08 08
08 08 08 08 02 02 02 08 08 08 08 02 02 02 02 02 02 02 02 02 08 08 08 08 02 02 02 08 08 08
08 08 08 08 08 02 02 02 08 08 08 08 08 08 08 08 08 08 08 08 08 08 08 02 02 02 08 08 08 08
08 08 08 02 02 02 02 02 08 08 02 02 02 02 02 02 02 02 02 02 08 08 02 02 02 08 08 08 08 08
08 02 02 02 08 08 08 08 02 02 02 02 02 02 02 02 02 02 02 02 02 02 02 02 08 08 08 08 08 08
08 02 08 08 08 08 02 02 02 02 08 08 08 08 08 02 08 08 08 02 02 02 02 08 08 08 08 08 08 08
08 08 08 08 08 02 02 02 02 08 08 08 08 08 02 02 08 08 08 08 08 08 08 08 08 08 08 08 08 08
04 02 02 02 02 02 02 08 08 08 08 08 08 02 02 08 04 02 02 02 02 02 02 02 02 02 02 02 05 08
04 02 02 02 02 08 08 08 08 08 02 02 02 02 08 08 04 02 02 02 02 02 02 02 02 02 02 02 05 08
08 08 08 08 08 08 08 08 08 08 08 08 08 08 08 08 08 08 08 08 08 08 08 08 08 08 08 08 08 08
09
00 29 2 1 2
04 0 29 27 27
04 0 28 27 28
03 0 15 27 27
03 16 28 18 15
03 18 15 15 13
01 1 29 1 1
01 2 29 1 1
00 18 16 1 2
0
1
02 14 12
0