/Assets/Backgrounds/jungle.png
/Assets/Tiles/jungletemp.png
14
9
11 11 11 11 11 11 11 11 11 11 11 11 11 11
11 02 00 00 00 00 00 00 00 00 00 00 01 11
11 02 00 00 00 00 00 00 00 00 00 00 01 11
11 02 00 00 00 00 00 00 00 00 00 00 01 11
11 02 00 00 00 00 00 00 00 00 00 00 01 11
11 02 00 00 00 00 00 00 00 00 00 00 00 00
11 02 00 00 00 00 00 01 10 10 10 10 10 10
00 00 01 10 10 02 00 00 11 11 11 11 11 11
10 10 10 13 12 10 10 10 13 11 11 11 11 11
2
0 -1 7 12 3
5 14 5 1 9
1
1 6 7
0
0