/Assets/Backgrounds/f854a3_6566d25b103646ce9c2a5438f8c78da4.jpg
/Assets/Tiles/jungletemp.png
14
11
11 11 11 11 11 11 11 11 11 11 11 11 11 11
11 00 00 00 00 00 00 00 00 00 00 00 00 11
11 10 10 02 00 01 10 10 10 02 00 00 00 11
11 00 00 00 00 00 00 00 00 01 10 10 10 11
11 00 00 00 03 10 10 02 00 00 00 00 00 11
11 00 00 01 10 11 00 00 00 01 10 02 00 00
11 10 10 02 00 00 00 00 00 00 11 11 11 11
11 00 00 00 01 10 10 10 10 02 00 00 01 11
11 00 00 01 10 11 11 11 11 02 00 00 01 11
11 00 01 10 11 11 11 11 11 10 10 02 01 11
11 11 11 11 11 11 11 11 11 11 11 10 10 11
2
1 13 5 1 18
3 1 1 29 2
1
1 2 1
1
1 4 2
0