/Assets/Backgrounds/baackground.jpg
/Assets/Tiles/Bricks.png
30
30
08 08 08 08 08 08 08 08 08 08 08 08 08 08 08 08 08 08 08 08 08 08 08 08 08 08 08 08 08 08
08 02 02 02 02 02 02 02 08 08 08 08 08 02 02 02 02 02 08 08 08 02 02 02 08 04 02 02 08 08
08 02 02 08 08 08 02 02 08 08 08 08 02 02 08 08 08 02 02 08 08 02 02 02 02 08 08 02 02 08
08 02 08 08 08 08 08 02 02 02 02 02 02 08 08 08 08 08 02 02 08 02 08 08 02 02 08 08 02 08
08 02 02 02 08 08 08 08 08 02 02 02 08 08 08 02 02 02 08 02 08 02 02 08 08 02 02 02 02 08
08 08 02 02 02 02 08 08 02 02 08 08 08 08 08 02 08 02 02 02 08 08 02 02 08 08 02 08 08 08
08 08 08 02 02 02 02 02 02 08 08 08 08 02 02 02 08 08 02 02 08 08 08 02 02 02 02 08 08 08
08 08 08 08 02 02 02 02 08 08 08 08 08 02 02 08 02 08 08 02 02 08 08 08 02 02 08 08 08 08
08 08 08 02 02 08 08 08 08 08 08 08 02 02 08 02 02 02 08 08 02 02 08 08 08 02 02 08 08 08
08 02 02 02 08 08 02 08 08 08 08 02 02 08 02 02 08 02 02 08 02 02 02 02 08 02 02 02 08 08
08 02 02 02 08 02 02 02 08 08 02 02 08 08 08 02 02 02 08 02 02 08 02 02 02 08 02 02 02 08
08 02 08 08 04 02 08 02 05 08 02 02 08 08 08 08 02 08 02 02 08 08 08 02 02 08 08 02 02 08
08 02 02 08 08 02 02 02 08 08 02 08 08 08 08 08 08 02 02 02 08 08 02 02 02 08 08 02 02 08
08 08 02 02 08 08 03 08 08 08 02 02 02 08 08 02 02 02 08 08 08 02 02 02 08 08 08 08 02 08
08 08 08 02 02 08 08 08 08 08 08 02 02 02 02 02 02 08 08 08 02 02 02 08 08 02 02 02 02 08
08 08 08 08 02 02 02 02 02 08 08 08 02 02 02 02 08 08 08 02 02 02 08 02 02 02 02 08 08 08
08 08 08 08 08 02 02 02 02 08 08 08 08 08 08 02 02 08 02 02 02 08 02 02 02 02 08 08 08 08
08 08 08 08 08 08 08 02 02 02 08 08 08 08 08 08 02 02 02 02 08 02 02 02 02 02 02 08 08 08
08 02 02 02 02 02 08 08 02 02 02 08 08 08 08 02 02 02 02 08 02 02 02 08 08 08 02 02 02 08
08 02 02 02 02 02 02 08 08 02 02 02 02 02 02 02 02 08 08 02 02 02 08 08 08 08 08 02 02 08
08 02 08 08 08 02 02 02 08 08 02 02 02 02 02 02 08 08 08 02 02 08 08 08 08 08 08 08 02 08
08 02 02 02 08 08 02 02 02 08 08 08 08 02 02 08 08 08 08 08 02 02 08 08 08 08 08 02 02 08
08 08 02 02 02 08 08 02 02 02 08 02 02 02 08 08 08 08 08 08 02 02 02 08 08 08 02 02 08 08
08 08 08 02 02 02 08 08 02 02 02 02 02 08 08 08 08 08 08 08 08 02 02 02 02 02 02 08 08 08
08 08 08 08 02 02 02 08 08 02 02 02 08 08 08 08 02 02 02 02 08 08 02 02 08 08 08 08 08 08
08 08 08 08 08 02 02 02 08 08 08 08 08 08 08 02 02 02 02 02 02 08 08 02 02 02 08 08 08 08
08 02 02 02 08 08 02 02 08 08 08 08 08 08 08 02 02 08 08 02 02 02 08 08 02 02 02 08 08 08
04 02 02 02 05 08 08 02 02 02 02 02 02 02 02 02 02 08 08 08 02 02 08 08 08 02 02 02 02 05
04 02 02 02 05 08 08 02 02 02 02 02 02 02 02 02 08 08 08 08 08 02 02 02 02 02 02 02 02 05
08 08 08 08 08 08 08 08 08 08 08 08 08 08 08 08 08 08 08 08 08 08 08 08 08 08 08 08 08 08
07
03 28 29 1 29
03 29 28 1 29
04 13 7 29 2
04 25 1 6 10
04 6 13 2 26
04 4 28 6 10
03 0 28 1 1
0
0
0