/Assets/Backgrounds/jungle.png
/Assets/Tiles/jungletemp.png
25
26
11 11 11 11 11 11 11 11 11 11 11 11 11 11 11 11 11 11 11 11 11 11 11 11 11
11 00 00 00 00 00 00 00 00 00 00 00 00 00 00 00 00 00 00 00 00 00 00 00 11
11 00 00 00 00 00 00 00 00 00 00 00 00 00 00 00 00 00 00 00 00 00 00 00 11
11 00 00 00 00 00 00 00 00 00 00 00 00 00 00 00 00 00 00 00 00 01 10 10 11
11 00 00 00 00 10 00 00 00 00 01 10 10 00 00 00 00 00 00 00 00 01 13 13 11
11 10 10 10 10 11 00 00 00 00 01 11 11 10 00 00 00 00 00 00 00 01 13 13 11
11 11 11 13 11 11 00 00 00 00 01 11 11 11 00 00 00 00 00 00 00 01 13 13 11
11 00 00 00 00 00 00 00 00 00 01 11 11 11 10 00 00 00 00 00 00 01 13 13 11
11 00 00 00 00 00 00 00 00 00 01 11 11 11 11 10 10 00 00 00 00 00 00 00 11
11 00 00 00 00 00 00 00 00 00 00 00 00 00 00 00 00 00 00 00 10 00 00 00 11
11 00 00 00 00 00 00 00 00 00 00 00 00 00 00 00 00 00 00 00 00 00 00 00 11
11 10 10 10 10 10 10 10 10 00 10 10 10 10 10 10 10 10 10 00 00 00 00 00 11
11 00 00 00 00 00 00 00 00 00 00 00 00 00 00 00 00 11 11 10 10 00 00 00 11
11 00 00 00 00 00 00 00 00 00 00 00 00 00 00 00 00 11 11 11 11 10 10 00 11
11 10 10 10 00 00 00 00 00 01 10 10 10 10 00 00 00 11 11 11 11 11 11 00 11
11 11 11 11 00 00 00 01 10 10 11 11 11 11 10 00 00 11 11 11 11 11 11 10 11
11 05 00 00 00 00 01 10 11 11 11 11 11 11 11 10 00 11 11 11 11 11 11 11 11
11 05 00 00 00 00 01 11 11 11 11 11 11 11 11 11 10 11 11 00 00 00 11 11 11
11 10 10 10 10 10 10 11 11 11 11 11 11 11 11 11 11 11 11 00 00 00 00 00 11
11 11 11 11 11 11 11 11 11 11 11 11 11 11 11 11 11 11 11 00 00 00 00 00 11
11 00 00 00 00 00 00 00 00 00 00 00 00 11 11 11 11 11 11 10 10 00 00 00 11
11 00 00 00 00 00 00 00 00 00 00 00 00 00 00 00 00 00 00 00 00 00 01 10 11
11 10 10 10 00 00 00 01 10 10 10 10 10 10 00 00 00 00 00 00 00 01 10 11 11
11 05 05 00 00 00 00 01 11 11 11 11 11 11 00 00 00 00 00 00 00 00 00 00 11
11 10 10 10 10 10 10 10 11 11 11 11 11 11 10 10 10 10 10 10 00 00 00 00 11
11 11 11 11 11 11 11 11 11 11 11 11 11 11 11 11 11 11 11 11 10 10 10 10 11
2
2 1 17 19 19
0 2 23 7 4
7
1 2 3
1 11 3
1 12 10
1 2 13
1 8 21
1 15 23
1 21 24
0
0