/Assets/Backgrounds/f854a3_6566d25b103646ce9c2a5438f8c78da4.jpg
/Assets/Tiles/jungletemp.png
17
17
11 11 11 11 00 00 11 11 11 11 11 11 11 11 11 11 11
11 11 11 11 00 00 11 11 11 11 11 11 11 11 11 11 11
11 11 11 11 00 00 11 11 11 11 11 11 11 11 11 11 11
11 11 11 11 00 00 11 11 11 11 11 11 11 11 11 11 11
11 11 11 11 00 00 11 11 11 11 11 11 11 11 11 11 11
11 11 11 11 00 00 11 11 11 11 11 11 11 11 11 11 11
11 11 11 11 00 00 11 11 11 11 11 11 11 11 11 11 11
11 00 00 00 00 00 00 00 00 00 00 00 11 11 11 11 11
11 00 00 00 00 00 00 00 00 00 00 00 11 11 11 11 11
11 00 01 10 10 10 10 10 10 00 00 00 11 11 11 11 11
11 00 00 00 00 00 00 00 00 00 00 00 11 11 11 11 11
11 00 00 00 00 00 00 00 00 00 00 00 11 11 11 11 11
11 00 00 00 00 01 10 10 02 00 00 00 11 00 00 00 11
11 10 10 10 02 01 11 12 10 10 10 10 13 00 00 00 00
11 11 11 11 00 00 00 00 00 00 00 00 00 00 01 10 10
11 11 11 11 00 00 00 00 00 00 00 00 00 00 01 11 11
11 11 11 11 11 11 11 11 12 10 10 10 10 10 10 13 11
1
8 17 13 1 9
3
1 10 12
1 16 15
1 4 12
0
0