/Assets/Tiles/basicTileSheet1.png
30
30
11 11 11 11 11 11 11 11 11 11 11 11 11 11 11 11 11 11 11 11 11 11 11 11 11 11 11 11 11 11
11 02 02 02 02 02 02 02 02 02 11 02 02 02 02 02 11 11 11 11 11 11 11 11 02 02 02 02 02 01
11 02 02 02 02 11 11 11 11 02 11 02 11 11 11 02 02 11 11 11 11 11 02 02 02 02 02 02 02 01
11 11 11 11 11 11 11 02 02 02 11 02 02 02 11 11 02 02 11 11 11 11 11 11 02 10 10 10 10 11
11 11 11 11 11 11 02 02 11 11 11 11 11 02 02 11 11 02 02 02 11 11 11 11 02 02 11 11 11 11
11 11 11 11 11 02 02 11 11 11 11 11 11 11 02 02 11 11 11 02 02 02 11 11 10 02 02 11 11 11
11 11 11 11 02 02 11 11 11 11 11 11 11 11 11 02 02 02 11 11 11 02 02 11 11 10 02 02 02 11
11 11 02 02 02 11 11 11 11 11 11 11 11 11 11 11 11 02 02 11 11 11 11 11 11 11 10 10 02 11
11 02 02 11 11 11 11 11 11 11 11 11 11 11 11 11 11 11 02 02 02 02 02 02 02 11 11 02 02 11
11 02 11 11 11 11 02 02 02 02 02 02 02 02 02 02 02 02 02 02 02 02 02 02 02 02 02 02 11 11
11 02 02 02 11 11 02 10 10 10 10 10 10 10 10 10 10 10 10 02 02 11 11 11 11 11 11 11 11 11
11 11 11 02 11 02 02 02 11 11 11 11 11 11 11 11 11 11 11 02 02 11 11 11 11 11 11 11 02 11
11 11 02 02 11 02 10 02 02 11 11 02 02 02 02 02 02 02 11 10 02 02 11 11 11 11 02 02 11 11
11 02 02 11 02 02 11 10 02 02 11 02 02 02 10 02 02 02 11 11 10 02 02 11 11 02 02 11 11 11
11 02 11 11 02 11 11 11 10 02 11 02 02 02 11 02 02 02 11 11 11 10 02 02 02 02 11 11 11 11
11 01 11 02 02 11 11 02 02 02 11 02 02 02 11 10 02 02 11 11 11 11 10 02 02 11 11 11 11 11
11 11 11 02 11 11 11 02 10 10 11 02 02 02 02 02 02 02 01 11 11 11 11 02 02 02 11 11 11 11
11 02 02 02 11 11 11 02 02 02 11 10 10 10 10 10 10 10 11 11 11 11 02 02 10 02 02 11 11 11
11 02 11 11 11 11 11 10 10 02 11 11 11 11 11 11 11 11 11 11 11 02 02 10 11 11 02 02 11 11
11 02 02 02 11 11 11 11 11 02 02 02 11 11 11 11 11 11 11 11 02 02 10 11 11 11 11 02 11 11
11 11 11 02 02 11 11 11 11 10 10 02 02 11 11 11 11 11 11 02 02 10 11 11 11 11 02 02 11 11
11 11 11 11 02 02 02 11 11 11 11 10 02 02 02 02 02 02 02 02 10 11 11 11 11 02 02 11 11 11
11 11 11 11 11 11 02 11 11 11 11 11 10 10 10 10 10 10 10 10 11 11 11 11 02 02 11 11 11 11
11 11 11 02 02 02 02 02 11 11 02 02 02 02 02 02 02 02 02 11 11 11 11 02 02 11 11 11 11 11
11 02 02 02 10 10 10 10 11 02 02 10 11 11 11 11 11 11 02 02 11 11 02 02 11 11 11 11 11 11
11 02 10 11 11 11 11 02 02 02 11 11 11 11 11 11 11 11 11 02 02 02 02 11 11 11 11 11 11 11
11 10 11 11 11 02 02 02 11 11 11 11 11 11 11 11 11 11 11 11 11 11 11 11 11 11 11 11 11 11
01 02 02 02 02 02 11 11 11 11 11 11 11 11 11 11 11 11 11 11 11 11 11 11 11 02 02 02 02 11
01 02 02 02 02 11 11 11 11 11 11 11 11 11 11 01 02 02 02 02 02 02 02 02 02 02 02 02 02 11
11 10 10 10 10 11 11 11 11 11 11 11 11 11 11 10 10 10 10 10 10 10 10 10 10 10 10 10 10 11

