/Assets/Backgrounds/f854a3_6566d25b103646ce9c2a5438f8c78da4.jpg
/Assets/Tiles/jungletemp.png
14
9
11 11 11 11 11 11 11 11 11 11 11 11 11 11
11 00 00 00 00 00 00 00 00 00 00 00 00 11
11 00 00 00 00 00 00 00 00 00 00 00 00 11
11 00 00 00 00 00 00 00 00 00 00 00 00 11
11 00 00 00 00 00 00 00 00 00 00 00 00 11
11 00 00 00 00 00 00 00 00 00 00 00 00 00
11 00 00 00 00 00 00 01 10 10 10 10 10 10
00 00 01 10 10 02 00 00 11 11 11 11 11 11
10 10 10 11 11 10 10 10 11 11 11 11 11 11
2
0 -1 7 12 3
1 14 5 1 18
1
1 6 7
0
0