/Assets/Tiles/basicTileSheet1.png
14
14
11 11 11 11 11 11 11 11 11 11 11 11 11 11
11 01 01 01 01 11 01 01 01 01 01 11 11 11
11 01 01 01 01 01 01 01 01 01 01 01 11 11
11 10 10 01 01 10 01 01 01 01 10 10 11 11
11 11 01 01 10 11 10 01 10 10 11 11 11 11
11 01 01 10 11 01 01 01 01 01 11 11 11 11
11 01 01 01 01 01 10 10 01 01 01 01 11 11
11 10 10 10 01 10 11 11 10 01 01 01 11 11
11 01 01 11 10 01 01 11 11 10 01 01 11 11
11 01 01 01 01 01 01 01 01 11 10 01 11 11
11 10 10 10 10 10 01 01 01 01 01 01 11 11
11 11 11 11 11 11 01 01 01 01 10 10 11 11
11 11 11 11 11 00 01 01 01 10 11 11 11 11
11 11 11 11 11 11 11 11 11 11 11 11 11 11
1
0 05 12 10 02
1
1 02 02
0