/Assets/Backgrounds/f854a3_6566d25b103646ce9c2a5438f8c78da4.jpg
/Assets/Tiles/jungletemp.png
20
13
11 11 11 11 11 11 11 11 11 11 11 11 11 11 11 11 11 11 11 11
11 00 00 00 00 00 00 00 00 00 00 11 11 11 11 11 11 11 11 11
11 00 00 00 00 00 00 00 00 00 00 11 11 11 11 11 11 11 11 11
11 00 00 00 00 00 00 01 10 10 10 13 11 11 11 11 11 11 11 11
11 00 00 00 01 10 10 10 11 11 11 11 11 11 11 11 11 11 11 11
11 00 00 00 00 00 00 00 00 00 00 00 00 00 00 00 00 00 00 11
11 01 10 02 00 00 00 00 00 00 00 00 00 00 00 00 00 00 00 11
11 00 00 00 00 00 00 00 01 10 10 02 00 00 00 00 00 00 00 00
12 10 02 00 00 00 00 00 01 11 12 10 02 00 00 00 00 01 10 10
00 00 00 00 00 00 00 00 01 11 11 12 10 10 10 10 10 10 13 11
10 10 10 10 10 10 10 02 01 11 11 11 11 11 11 11 11 11 11 11
11 11 11 11 11 11 11 02 01 11 11 11 11 11 11 11 11 11 11 11
11 11 11 11 11 11 11 02 01 11 11 11 11 11 11 11 11 11 11 11
3
1 -1 9 12 5
6 7 13 4 0
6 8 13 4 0
1
1 9 2
0
0