/Assets/Backgrounds/f854a3_6566d25b103646ce9c2a5438f8c78da4.jpg
/Assets/Tiles/jungletemp.png
16
12
11 11 11 11 11 11 11 11 11 11 11 11 11 11 11 11
11 11 11 11 11 00 00 00 00 00 00 00 00 00 00 00
11 11 11 11 11 00 00 00 10 10 10 10 10 10 10 10
11 11 11 11 00 00 00 00 00 00 00 00 00 00 00 11
11 11 11 00 00 10 00 00 00 00 10 10 00 00 00 11
11 11 00 00 00 12 10 10 10 10 13 00 00 00 00 11
11 00 00 00 00 00 00 00 00 00 00 00 00 10 10 11
11 00 00 00 00 00 00 00 00 00 10 10 10 13 11 11
11 00 00 10 00 00 00 10 00 00 00 00 00 00 00 11
00 00 00 11 10 10 10 11 00 00 00 00 00 00 00 11
10 10 10 13 11 11 11 11 00 00 00 00 00 00 00 11
11 11 11 11 11 11 11 11 11 11 11 11 11 11 11 11
0
0
0
0