/Assets/Backgrounds/jungle.png
/Assets/Tiles/jungletemp.png
16
11
11 11 11 11 11 11 11 11 11 11 11 11 11 11 11 11
11 00 00 00 00 00 00 00 00 00 00 00 00 00 00 11
11 00 00 00 00 00 00 00 00 00 00 00 00 00 00 11
11 00 00 00 00 00 00 00 00 00 00 00 00 00 00 00
11 10 02 00 01 10 02 00 01 10 02 00 01 10 10 10
11 00 00 00 00 00 00 00 00 00 00 00 00 05 05 11
11 00 00 00 00 00 00 00 00 00 00 00 00 05 05 11
11 00 00 00 00 00 00 00 01 10 10 10 10 10 10 11
00 00 00 01 10 10 02 00 00 11 11 11 11 11 11 11
10 10 10 10 13 12 10 10 10 13 11 11 11 11 11 11
11 11 11 11 11 11 11 11 11 11 11 11 11 11 11 11
2
5 -1 8 18 7
9 16 3 1 2
1
1 14 6
1
3 1 2
0