/Assets/Backgrounds/f854a3_6566d25b103646ce9c2a5438f8c78da4.jpg
/Assets/Tiles/jungletemp.png
16
11
11 11 11 11 11 11 11 11 11 11 11 11 11 11 11 11
11 00 00 00 00 00 00 00 00 00 00 00 00 00 00 11
11 00 00 00 00 00 00 00 00 00 00 00 00 00 00 11
11 00 00 00 00 00 00 00 00 00 00 00 00 00 00 00
11 10 02 00 01 10 02 00 01 10 02 00 01 10 10 10
11 00 00 00 00 00 00 00 00 00 00 00 00 05 05 11
11 00 00 00 00 00 00 00 00 00 00 00 00 05 05 11
11 00 00 00 00 00 00 00 01 10 10 10 10 10 10 11
00 00 00 01 10 10 02 00 00 11 11 11 11 11 11 11
10 10 10 10 13 12 10 10 10 13 11 11 11 11 11 11
11 11 11 11 11 11 11 11 11 11 11 11 11 11 11 11
1
5 -1 8 18 7
1
1 14 6
0
0