/Assets/Backgrounds/f854a3_6566d25b103646ce9c2a5438f8c78da4.jpg
/Assets/Tiles/jungletemp.png
14
9
11 11 11 11 11 11 11 11 11 11 11 11 11 11
11 00 00 00 00 00 00 00 00 00 00 00 00 11
11 00 00 00 00 00 00 00 00 00 00 00 00 11
11 00 00 00 00 00 00 00 00 00 00 00 00 00
11 00 00 00 00 00 00 00 00 01 10 10 10 10
00 00 00 00 00 00 00 00 00 00 00 00 00 11
10 10 10 10 10 10 10 10 10 02 00 00 00 11
11 11 11 11 11 11 11 11 12 10 10 02 00 00
11 11 11 11 11 11 11 11 11 11 12 10 10 10
3
3 0 5 27 1
1 14 3 1 7
2 14 7 22 2
0
0
0