/Assets/Backgrounds/f854a3_6566d25b103646ce9c2a5438f8c78da4.jpg
/Assets/Tiles/basicTileSheet1.png
30
30
11 11 11 11 11 11 11 11 11 11 11 11 11 11 11 11 11 11 11 11 11 11 11 11 11 11 11 11 11 11
11 02 02 02 02 02 02 02 11 11 11 11 11 02 02 02 02 02 11 11 11 02 02 02 11 01 02 02 11 11
11 02 02 11 11 11 02 02 11 11 11 11 02 02 11 11 11 02 02 11 11 02 02 02 02 11 11 02 02 11
11 02 11 11 11 11 11 02 02 02 02 02 02 11 11 11 11 11 02 02 11 02 11 11 02 02 11 11 02 11
11 02 02 02 11 11 11 11 10 02 02 02 11 11 11 02 02 02 11 02 11 02 02 11 11 02 02 02 02 11
11 11 02 02 02 02 11 11 02 02 11 11 11 11 11 02 11 02 02 02 11 11 02 02 11 11 02 11 11 11
11 11 11 02 02 02 02 02 02 11 11 11 11 02 02 02 11 11 02 02 11 11 11 02 02 02 02 11 11 11
11 11 11 11 02 02 02 02 11 11 11 11 11 02 02 11 02 11 11 02 02 11 11 11 02 02 11 11 11 11
11 11 11 02 02 11 11 11 11 11 11 11 02 02 11 02 02 02 11 11 02 02 11 11 11 02 02 11 11 11
11 02 02 02 11 11 02 11 11 11 11 02 02 11 02 02 10 02 02 11 02 02 02 02 11 02 02 02 11 11
11 02 02 02 11 02 02 02 11 11 02 02 11 11 11 02 02 02 11 02 02 11 02 02 02 11 02 02 02 11
11 02 11 11 01 02 10 02 01 11 02 02 11 11 11 11 02 11 02 02 11 11 11 02 02 11 10 02 02 11
11 02 02 11 11 02 02 02 11 11 02 11 11 11 11 11 11 02 02 02 11 11 02 02 02 11 11 02 02 11
11 11 02 02 11 11 01 11 11 11 02 02 02 11 11 02 02 02 11 11 11 02 02 02 11 11 11 11 02 11
11 11 11 02 02 11 11 11 11 11 11 02 02 02 02 02 02 11 11 11 02 02 02 11 11 02 02 02 02 11
11 11 11 11 02 02 02 02 02 11 11 11 02 02 02 02 11 11 11 02 02 02 11 02 02 02 02 11 11 11
11 11 11 11 11 02 02 02 02 11 11 11 11 11 11 02 02 11 02 02 02 11 02 02 02 02 11 11 11 11
11 11 11 11 11 11 11 02 02 02 11 11 11 11 11 11 02 02 02 02 11 02 02 02 02 02 02 11 11 11
11 02 02 02 02 02 11 11 02 02 02 11 11 11 11 02 02 02 02 11 02 02 02 11 11 11 02 02 02 11
11 02 02 02 02 02 02 11 11 02 02 02 02 02 02 02 02 11 11 02 02 02 11 11 11 11 11 02 02 11
11 02 11 11 11 02 02 02 11 11 02 02 02 02 02 02 11 11 11 02 02 11 11 11 11 11 11 11 02 11
11 02 02 02 11 11 02 02 02 11 11 11 11 02 02 11 11 11 11 11 02 02 11 11 11 11 11 02 02 11
11 11 02 02 02 11 11 02 02 02 11 02 02 02 11 11 11 11 11 11 02 02 02 11 11 11 02 02 11 11
11 11 11 02 02 02 11 11 02 02 02 02 02 11 11 11 11 11 11 11 11 02 02 02 02 02 02 11 11 11
11 11 11 11 02 02 02 11 11 02 02 02 11 11 11 11 02 02 02 02 11 11 02 02 11 11 11 11 11 11
11 11 11 11 11 02 02 02 11 11 11 11 11 11 11 02 02 02 02 02 02 11 11 02 02 02 11 11 11 11
11 02 02 02 11 11 02 02 11 11 11 11 11 11 11 02 02 11 11 02 02 02 11 11 02 02 02 11 11 11
01 02 02 02 01 11 11 02 02 02 02 02 02 02 02 02 02 11 11 11 02 02 11 11 11 02 02 02 02 01
01 02 02 02 01 11 11 02 02 02 02 02 02 02 02 02 11 11 11 11 11 02 02 02 02 02 02 02 02 01
11 11 11 11 11 11 11 11 11 11 11 11 11 11 11 11 11 11 11 11 11 11 11 11 11 11 11 11 11 11
07
03 28 29 1 29
03 29 28 1 29
04 13 7 29 2
04 25 1 6 10
04 6 13 2 26
04 4 28 6 10
03 0 28 1 1
0
0
0