/Assets/Backgrounds/f854a3_6566d25b103646ce9c2a5438f8c78da4.jpg
/Assets/Tiles/basicTileSheet1.png
14
11
11 11 11 11 11 11 11 11 11 11 11 11 11 11
11 00 00 00 00 00 00 00 00 00 00 00 00 11
11 10 10 00 00 00 10 10 10 00 00 00 00 11
11 00 00 00 00 00 00 00 00 00 10 10 10 11
11 00 00 00 00 10 10 00 00 00 00 00 00 11
11 00 00 00 10 11 00 00 00 00 11 00 00 00
11 10 10 00 00 00 00 00 00 00 11 11 11 11
11 00 00 00 00 10 10 10 10 00 00 00 00 11
11 00 00 00 10 11 11 11 11 00 00 00 00 11
11 00 00 10 11 11 11 11 11 10 10 00 00 11
11 11 11 11 11 11 11 11 11 11 11 10 10 11
2
1 13 5 2 18
3 1 1 29 2
1
1 2 1
1
1 4 2
0