/Assets/Tiles/basicTileSheet1.png
20
20
11 11 11 11 11 11 11 11 11 11 11 11 11 11 11 11 11 11 11 11
11 02 02 02 02 11 11 11 11 11 11 11 11 11 02 02 11 11 11 11
11 10 02 10 11 11 11 11 11 11 11 11 11 11 11 02 02 02 02 11
11 11 02 11 11 11 11 11 11 11 11 11 11 02 02 02 10 10 10 11
11 11 02 11 11 11 11 11 11 11 11 11 02 02 02 10 11 11 11 11
11 11 02 02 02 02 02 02 02 02 02 02 02 02 02 02 02 02 11 11
11 11 10 10 10 10 10 10 10 10 10 10 10 10 11 11 11 02 02 11
11 11 11 11 11 11 11 11 11 11 11 11 11 11 11 11 11 10 02 11
11 02 02 02 02 02 02 02 02 02 02 02 02 02 02 02 02 02 02 01
11 02 02 02 02 02 02 02 02 10 10 10 10 10 10 10 10 10 10 11
11 02 02 10 10 10 10 10 10 11 11 11 11 11 11 11 11 11 11 11
11 02 02 02 02 02 02 11 11 11 11 11 11 11 11 11 11 11 11 11
11 11 11 11 11 02 02 02 11 11 11 11 11 11 11 11 11 11 11 11
11 11 11 11 11 11 02 02 02 11 11 11 11 11 11 11 11 11 11 11
11 11 11 11 11 11 11 02 02 02 11 11 11 11 11 11 11 11 11 11
11 11 11 11 11 11 11 11 02 02 02 11 11 11 11 11 02 02 11 11
11 11 11 11 11 11 11 11 11 02 02 02 11 11 11 11 11 02 02 11
11 11 11 11 11 11 11 11 11 11 02 02 02 02 11 11 11 10 02 11
01 02 02 02 02 02 02 02 02 02 02 02 11 02 02 02 02 02 02 11
11 10 10 10 10 10 10 10 10 10 10 10 10 10 10 10 10 10 10 11
2
0 0 18 11 5
2 19 8 1 9
1
1 16 18


