/Assets/Backgrounds/jungle.png
/Assets/Tiles/jungletemp.png
17
17
11 11 11 11 02 01 11 11 11 11 11 11 11 11 11 11 11
11 11 11 11 02 01 11 11 11 11 11 11 11 11 11 11 11
11 11 11 11 02 01 11 11 11 11 11 11 11 11 11 11 11
11 11 11 11 02 01 11 11 11 11 11 11 11 11 11 11 11
11 11 11 11 02 01 11 11 11 11 11 11 11 11 11 11 11
11 11 11 11 02 01 11 11 11 11 11 11 11 11 11 11 11
11 11 11 11 02 01 11 11 11 11 11 11 11 11 11 11 11
11 02 00 00 00 00 00 00 00 00 00 01 11 11 11 11 11
11 02 00 00 00 00 00 00 00 00 00 01 11 11 11 11 11
11 02 01 10 10 10 10 10 10 00 00 01 11 11 11 11 11
11 02 00 00 00 00 00 00 00 00 00 01 11 11 11 11 11
11 02 00 00 00 00 00 00 00 00 00 01 11 11 11 11 11
11 02 00 00 00 01 10 10 02 00 00 01 11 02 00 01 11
11 10 10 10 02 01 11 12 10 10 10 10 13 02 00 00 00
11 11 11 11 02 00 00 00 00 00 00 00 00 00 01 10 10
11 11 11 11 02 00 00 00 00 00 00 00 00 00 01 11 11
11 11 11 12 10 10 10 10 10 10 10 10 10 10 10 13 11
1
8 17 13 1 9
3
1 10 12
1 14 15
1 4 12
0
0