/Assets/Tiles/basicTileSheet1.png
30
30
11 11 11 11 11 11 11 11 11 11 11 11 11 11 11 11 11 11 11 11 11 11 11 11 11 11 11 11 11 11
11 02 02 02 02 02 02 02 02 02 11 02 02 02 02 02 11 11 11 11 11 11 11 11 02 02 02 02 02 01
11 02 02 02 02 10 10 10 10 02 11 02 10 10 10 02 02 11 11 11 11 11 02 02 02 02 02 02 02 01
11 10 10 10 10 11 11 02 02 02 11 02 02 02 11 10 02 02 11 11 11 11 11 11 02 10 10 10 10 11
11 11 11 11 11 11 02 02 10 10 11 10 10 02 02 11 10 02 02 02 11 11 11 11 02 02 11 11 11 11
11 11 11 11 11 02 02 10 11 11 11 11 10 10 02 02 11 10 10 02 02 02 11 11 10 02 02 11 11 11
11 11 11 11 02 02 10 11 11 11 11 11 11 10 10 02 02 02 11 10 10 02 02 11 11 10 02 02 02 11
11 11 02 02 02 10 11 11 11 11 11 11 11 11 11 10 10 02 02 11 11 10 10 11 11 11 10 10 02 11
11 02 02 10 10 11 11 11 11 11 11 11 11 11 11 11 11 10 02 02 02 02 02 02 02 11 11 02 02 11
11 02 10 11 11 11 02 02 02 02 02 02 02 02 02 02 02 02 02 02 02 02 02 02 02 02 02 02 10 11
11 02 02 02 11 11 02 10 10 10 10 10 10 10 10 10 10 10 10 02 02 10 10 10 10 10 10 10 11 11
11 10 10 02 11 02 02 02 11 11 11 11 11 11 11 11 11 11 11 02 02 11 11 11 11 11 11 11 02 11
11 11 02 02 11 02 10 02 02 11 11 02 02 02 02 02 02 02 11 10 02 02 11 11 11 11 02 02 10 11
11 02 02 10 02 02 11 10 02 02 11 02 02 02 10 02 02 02 11 11 10 02 02 11 11 02 02 10 11 11
11 02 10 11 02 11 11 11 10 02 11 02 02 02 11 02 02 02 11 11 11 10 02 02 02 02 10 11 11 11
11 01 11 02 02 11 11 02 02 02 11 02 02 02 11 10 02 02 11 11 11 11 10 02 02 10 11 11 11 11
11 11 11 02 11 11 11 02 10 10 11 02 02 02 02 02 02 02 01 11 11 11 11 02 02 02 11 11 11 11
11 02 02 02 11 11 11 02 02 02 11 10 10 10 10 10 10 10 11 11 11 11 02 02 10 02 02 11 11 11
11 02 11 11 11 11 11 10 10 02 11 11 11 11 11 11 11 11 11 11 11 02 02 10 11 10 02 02 11 11
11 02 02 02 11 11 11 11 11 02 02 02 11 11 11 11 11 11 11 11 02 02 10 11 11 11 10 02 11 11
11 10 10 02 02 11 11 11 11 10 10 02 02 11 11 11 11 11 11 02 02 10 11 11 11 11 02 02 11 11
11 11 11 10 02 02 02 11 11 11 11 10 02 02 02 02 02 02 02 02 10 11 11 11 11 02 02 10 11 11
11 11 11 11 10 10 02 11 11 11 11 11 10 10 10 10 10 10 10 10 11 11 11 11 02 02 10 11 11 11
11 11 11 02 02 02 02 02 11 11 02 02 02 02 02 02 02 02 02 11 11 11 11 02 02 10 11 11 11 11
11 02 02 02 10 10 10 10 11 02 02 10 10 10 10 10 10 10 02 02 11 11 02 02 10 11 11 11 11 11
11 02 10 11 11 11 11 02 02 02 10 11 11 11 11 11 11 11 10 02 02 02 02 10 11 11 11 11 11 11
11 10 11 11 11 02 02 02 10 10 11 11 11 11 11 11 11 11 11 10 10 10 10 11 11 11 11 11 11 11
01 02 02 02 02 02 10 10 11 11 11 11 11 11 11 11 11 11 11 11 11 11 11 11 11 02 02 02 02 11
01 02 02 02 02 10 11 11 11 11 11 11 11 11 11 01 02 02 02 02 02 02 02 02 02 02 02 02 02 11
11 10 10 10 10 11 11 11 11 11 11 11 11 11 11 10 10 10 10 10 10 10 10 10 10 10 10 10 10 11
07
04 0 29 1 1
04 0 28 1 1
04 1 15 1 1
03 16 28 18 15
03 18 15 15 20
01 1 29 1 1
01 2 29 1 1
