/Assets/Backgrounds/f854a3_6566d25b103646ce9c2a5438f8c78da4.jpg
/Assets/Tiles/jungletemp.png
14
23
11 11 11 11 11 11 11 11 11 11 11 11 11 11
11 05 05 05 05 05 05 05 05 05 05 05 05 11
05 05 05 05 05 05 05 05 05 05 05 05 05 11
11 10 10 10 10 10 10 05 05 05 05 05 05 11
11 11 11 11 11 11 11 05 05 05 05 05 05 11
11 11 11 11 11 11 12 10 10 10 05 05 10 11
11 11 11 05 05 05 05 05 05 05 05 05 05 11
11 05 05 05 05 05 05 05 05 10 10 10 10 11
11 05 05 05 05 05 05 10 10 13 11 11 11 11
11 05 05 10 10 10 10 13 11 11 11 11 11 11
11 10 05 05 05 05 05 05 11 11 11 11 11 11
11 05 05 05 05 05 05 05 05 05 05 11 11 11
11 05 10 05 05 05 05 05 05 05 05 05 05 11
11 05 05 05 05 05 05 05 05 05 05 05 05 11
12 10 10 10 05 05 05 05 05 05 05 05 05 11
11 11 11 12 10 10 10 05 05 05 05 05 05 11
11 11 11 11 11 11 12 10 10 05 05 05 05 11
11 05 05 05 05 05 05 05 05 05 05 05 05 11
11 05 05 05 05 05 05 05 05 05 10 10 10 11
11 05 05 05 05 05 10 10 10 10 13 11 11 11
05 05 05 10 10 10 13 11 11 11 11 11 11 11
10 10 10 13 11 11 11 11 11 11 11 11 11 11
11 11 11 11 11 11 11 11 11 11 11 11 11 11
2
8 -1 20 14 1
7 -1 2 13 3
0
0
0