/Assets/Backgrounds/jungle.png
/Assets/Tiles/jungletemp.png
14
23
11 11 11 11 11 11 11 11 11 11 11 11 11 11
11 05 05 05 05 05 05 05 05 05 05 05 05 11
05 05 05 05 05 05 05 05 05 05 05 05 05 11
11 10 10 10 10 10 10 05 05 05 05 05 05 11
11 11 11 11 11 11 11 05 05 05 05 05 05 11
11 11 11 11 11 11 12 10 10 10 05 05 10 11
11 11 11 05 05 05 05 05 05 05 05 05 05 11
11 05 05 05 05 05 05 05 05 10 10 10 10 11
11 05 05 05 05 05 05 10 10 13 11 11 11 11
11 05 05 10 10 10 10 13 11 11 11 11 11 11
11 10 05 05 05 05 05 05 11 11 11 11 11 11
11 05 05 05 05 05 05 05 05 11 11 11 11 11
11 05 10 05 05 05 05 05 10 11 05 05 05 11
11 05 05 05 05 05 05 05 05 05 05 05 05 11
12 10 10 10 05 05 05 05 05 05 05 05 05 11
11 11 11 12 10 10 10 05 05 05 05 05 05 11
11 11 11 11 11 11 12 10 10 05 05 05 05 11
11 05 05 05 05 05 05 05 05 05 05 05 05 11
11 05 05 05 05 05 05 05 05 05 10 10 10 11
11 05 05 05 05 05 10 10 10 10 13 11 11 11
05 05 05 10 10 10 13 11 11 11 11 11 11 11
10 10 10 13 11 11 11 11 11 11 11 11 11 11
11 11 11 11 11 11 11 11 11 11 11 11 11 11
2
8 -1 20 14 1
7 -1 2 13 3
13
1 9 4
1 11 4
1 13 4
1 11 6
1 10 6
1 9 6
1 8 6
1 5 8
1 4 8
1 1 9
1 1 13
1 3 13
1 5 14
1
1 8 11
0