/Assets/Backgrounds/jungle.png
/Assets/Tiles/jungletemp.png
16
12
11 11 11 11 11 11 11 11 11 11 11 11 11 11 11 11
11 11 11 11 11 02 00 00 00 00 00 00 00 00 00 00
11 11 11 11 11 02 00 01 10 10 10 10 10 10 10 10
11 11 11 11 02 00 00 00 00 00 00 00 00 00 01 11
11 11 11 02 01 10 02 00 00 01 10 10 02 00 01 11
11 11 02 00 01 12 10 10 10 10 13 02 00 00 01 11
11 02 00 00 00 00 00 00 00 00 00 00 01 10 10 11
11 02 00 00 00 00 00 00 00 01 10 10 10 13 11 11
11 02 01 10 00 00 01 10 05 05 05 05 05 05 05 11
00 00 01 11 10 10 10 11 05 05 10 05 05 05 05 11
10 10 10 13 11 11 11 11 05 05 05 05 05 05 05 11
11 11 11 11 11 11 11 11 11 11 11 11 11 11 11 11
2
6 -1 9 15 13
9 16 1 1 20
6
1 6 8
1 10 10
1 12 10
1 13 10
1 14 10
1 8 4
0
0