/Assets/Backgrounds/f854a3_6566d25b103646ce9c2a5438f8c78da4.jpg
/Assets/Tiles/basicTileSheet1.png
30
30
11 11 11 11 11 11 11 11 11 11 11 11 11 11 11 11 11 11 11 11 11 11 11 11 11 11 11 11 11 11
11 01 02 02 02 02 02 02 02 02 11 02 02 02 02 02 02 11 11 11 11 11 11 02 02 02 02 02 02 01
11 01 02 02 02 10 10 10 10 02 11 02 10 10 10 02 02 02 11 11 11 11 11 02 02 02 02 02 02 01
11 10 10 10 10 11 02 02 02 02 11 02 02 02 02 10 02 02 02 02 11 11 11 02 02 10 10 10 10 11
11 11 11 11 11 02 02 02 10 10 11 10 10 02 02 02 10 02 02 02 11 11 11 02 02 02 02 11 11 11
11 11 11 11 02 02 02 10 11 11 11 11 11 10 02 02 02 10 10 02 02 02 11 10 10 02 02 02 11 11
11 11 11 11 02 02 10 11 11 11 11 11 11 11 10 02 02 02 11 10 10 02 02 11 11 10 02 02 02 11
11 02 02 02 02 10 11 11 11 11 11 11 11 11 11 10 02 02 02 11 11 10 10 11 11 11 10 02 02 11
11 02 02 10 10 11 02 02 02 02 02 02 02 02 02 02 02 10 02 02 02 02 02 02 02 02 02 02 02 11
11 02 10 11 11 11 02 02 02 02 02 02 02 02 02 02 02 02 02 02 02 02 02 02 02 02 02 02 10 11
11 02 02 02 11 11 02 10 10 10 10 10 10 10 10 10 10 10 10 02 02 10 10 10 10 10 10 10 11 11
11 10 10 02 11 02 02 02 11 11 11 11 11 11 11 11 11 11 11 02 02 02 11 11 11 11 11 11 02 11
11 11 02 02 11 02 02 02 02 11 11 02 02 02 02 02 02 02 11 10 02 02 02 11 11 11 02 02 02 11
11 02 02 02 11 02 02 10 02 02 11 02 02 02 10 02 02 02 11 11 10 02 02 02 11 02 02 02 02 11
11 02 02 10 11 02 02 11 10 02 11 02 02 02 11 02 02 02 11 11 11 10 02 02 02 02 10 02 02 11
11 01 10 11 02 02 10 02 02 02 11 02 02 02 11 10 02 02 11 11 11 11 10 02 02 10 11 02 11 11
11 11 11 02 02 10 11 02 10 10 11 02 02 02 02 02 02 02 01 11 11 11 02 02 02 02 11 02 02 11
11 02 02 02 10 11 11 02 02 02 11 10 10 10 10 10 10 10 11 11 11 02 02 02 10 02 02 02 02 11
11 02 02 10 11 11 11 10 02 02 02 11 11 11 11 11 11 11 11 11 02 02 02 10 11 10 02 02 11 11
11 02 02 02 11 11 11 11 11 02 02 02 02 11 11 11 11 11 02 02 02 02 10 11 11 11 10 02 11 11
11 10 10 02 02 11 11 11 11 02 02 02 02 02 02 02 02 02 02 02 02 10 11 11 11 02 02 02 11 11
11 11 11 10 02 02 02 11 11 10 10 02 02 02 02 02 02 02 02 02 10 11 11 11 02 02 02 10 11 11
11 11 11 11 10 02 02 02 11 11 11 10 10 10 10 10 10 10 10 10 11 11 11 02 02 02 10 11 11 11
11 11 11 02 02 02 02 02 11 11 02 02 02 02 02 02 02 02 02 02 11 11 02 02 02 10 11 11 11 11
11 02 02 02 10 10 10 10 02 02 02 02 02 02 02 02 02 02 02 02 02 02 02 02 10 11 11 11 11 11
11 02 10 10 11 11 02 02 02 02 10 10 10 10 10 02 10 10 10 02 02 02 02 10 11 11 11 11 11 11
11 10 11 11 11 02 02 02 02 10 11 11 11 11 02 02 11 11 11 10 10 10 10 11 11 11 11 11 11 11
01 02 02 02 02 02 02 10 10 11 11 11 11 02 02 10 01 02 02 02 02 02 02 02 02 02 02 02 01 11
01 02 02 02 02 10 10 11 11 11 02 02 02 02 11 11 01 02 02 02 02 02 02 02 02 02 02 02 01 11
11 10 10 10 10 11 11 11 11 11 10 10 10 10 11 10 10 10 10 10 10 10 10 10 10 10 10 10 10 11
08
04 0 29 27 27
04 0 28 27 28
03 1 15 27 27
03 16 28 18 15
03 18 15 15 13
01 1 29 1 1
01 2 29 1 1
00 18 16 1 2
0
0
0