/Assets/Tiles/basicTileSheet1.png
10
10
11 11 11 11 11 11 11 11 11 11
11 02 02 02 02 02 02 02 02 11
11 02 02 10 10 10 10 10 10 11
11 10 02 02 02 02 02 02 02 11
11 11 10 02 02 02 02 02 02 11
11 02 02 10 10 10 10 02 02 11
11 02 02 02 02 02 02 02 10 11
11 02 02 02 02 02 02 10 11 11
11 10 10 10 10 10 10 11 11 11
11 11 11 11 11 11 11 11 11 11
00
00