/Assets/Tiles/basicTileSheet1.png
14
11
11 11 11 11 11 11 11 11 11 11 11 11 11 11
11 01 01 01 01 01 01 01 01 01 01 01 01 11
11 10 10 01 01 01 10 10 10 01 01 01 01 11
11 01 01 01 01 01 01 01 01 01 10 10 10 11
11 01 01 01 01 10 10 01 01 01 01 01 01 11
11 01 01 01 10 11 01 01 01 01 11 11 01 00
11 10 10 01 01 01 01 01 01 01 11 11 11 11
11 01 01 01 01 10 10 10 10 01 01 01 01 11
11 01 01 01 10 11 11 11 11 01 01 01 01 11
11 01 01 10 11 11 11 11 11 10 10 01 01 11
11 11 11 11 11 11 11 11 11 11 11 10 10 11
1
1 13 5 2 18
1
1 2 1